Strategy:,Relic in Zone#3 Count:,Relic in Zone#2 Count:,Relic in Zone#1 Count:,Glyph in Cryptobox Count:,Balance on Stone Count:,Sum: 
1,1,1,1,9,0,88
2,1,1,1,8,1,106
3,1,1,0,13,0,86
4,1,1,0,12,1,104
5,1,0,1,14,0,78
6,1,0,1,13,1,96
7,1,0,0,18,0,76
8,1,0,0,17,1,94
9,0,1,1,15,0,60
10,0,1,1,14,1,78
11,0,1,0,19,0,58
12,0,1,0,18,1,76
13,0,0,1,20,0,50
14,0,0,1,19,1,68
15,0,0,0,24,0,48
16,0,0,0,23,1,66
